Team,Year,G,W,L,Pct,Rushing Att,Rushing Yds,Rushing Y/A,Rushing TD,Rushing Y/G,Total Receptions,Receiving Yds_Rec,Receiving Y/R,Receiving TD_Rec,Receiving Y/G_Rec,Scrimmage Plays,Yds_Scrimmage,Scrimmage Avg,TD_Scrimmage,Cmp,Att,Cmp%,Yds,TD,TD%,Int,Int%,Y/A,AY/A,Y/C,Y/G,Rate
Air Force,2024,12,5,7,0.417,664,2688,4.1,24,224.0,62,1077,17.4,5,89.8,726,3765,5.2,29,62,138,44.9,1077,5,3.6,10,7.2,7.8,5.27,17.4,89.8,107.9
Air Force,2023,13,9,4,0.692,702,3660,5.3,36,281.5,55,1105,20.1,7,85.0,757,4765,6.3,43,55,105,52.4,1105,7,6.7,6,5.7,10.5,9.29,20.1,85.0,151.4
Air Force,2022,13,10,3,0.769,776,4247,5.6,37,326.7,41,916,22.3,8,70.5,817,5163,6.4,45,41,87,47.7,916,8,9.3,2,2.3,10.7,11.47,22.3,70.5,163.2
Akron,2024,12,4,8,0.333,339,1204,3.6,11,100.3,234,2789,11.9,16,232.4,573,3993,7.0,27,234,419,56.0,2789,16,3.8,10,2.4,6.7,6.36,11.9,232.4,119.9
Akron,2023,12,2,10,0.167,339,972,2.9,12,81.0,258,2371,9.2,10,197.6,597,3343,5.6,22,258,425,61.0,2371,10,2.4,15,3.5,5.6,4.48,9.2,197.6,108.8
Akron,2022,12,2,10,0.167,371,1075,2.9,16,89.6,323,3397,10.5,15,283.1,694,4472,6.5,31,323,502,64.6,3397,15,3.0,12,2.4,6.8,6.31,10.5,283.1,126.8
Alabama,2024,13,9,4,0.692,479,2260,4.8,41,173.8,226,3065,13.6,17,236.4,705,5333,7.6,58,226,354,64.0,3073,17,4.8,11,3.1,8.7,8.27,13.6,236.4,146.8
Alabama,2023,14,12,2,0.857,546,2417,4.6,32,172.6,208,3086,14.8,23,220.4,754,5503,7.4,55,208,325,64.0,3086,23,7.1,6,1.8,9.5,10.08,14.8,220.4,163.4
Alabama,2022,13,11,2,0.846,448,2542,5.8,26,195.5,280,3660,13.1,37,281.5,728,6202,8.6,63,280,438,63.9,3660,37,8.4,8,1.8,8.4,9.22,13.1,281.5,158.3
Appalachian State,2024,11,5,6,0.455,376,1692,4.7,13,153.8,218,3003,13.8,23,273.0,594,4695,8.0,36,218,392,55.6,3003,23,5.9,16,4.1,7.7,7.0,13.8,273.0,131.2
Appalachian State,2023,14,9,5,0.643,523,2408,4.7,23,172.0,300,3830,12.8,34,273.6,823,6238,7.6,57,300,472,63.7,3830,34,7.2,10,2.1,8.1,8.62,12.8,273.6,151.6
Appalachian State,2022,12,6,6,0.5,472,2453,5.2,27,204.4,226,3011,13.3,28,250.9,698,5464,7.8,55,226,359,63.0,3011,28,7.8,6,1.7,8.4,9.19,13.3,250.9,155.8
Arizona,2024,12,4,8,0.333,327,1279,4.0,11,106.6,262,2975,11.4,18,247.9,589,4254,7.2,29,262,437,60.0,2975,18,4.1,13,3.0,6.8,6.29,11.4,247.9,124.8
Arizona,2023,13,10,3,0.769,386,1816,4.8,17,139.7,332,4008,12.1,36,308.3,718,5824,8.1,53,332,464,71.7,4008,36,7.8,11,2.4,8.7,9.14,12.1,308.3,165.3
Arizona,2022,12,5,7,0.417,344,1722,5.1,19,143.5,283,3821,13.5,26,318.4,627,5543,8.9,45,283,459,61.9,3821,26,5.7,13,2.8,8.4,8.22,13.5,318.4,145.2
Arizona State,2024,14,11,3,0.786,570,2799,5.0,30,199.9,234,3213,13.7,26,229.5,804,6012,7.6,56,234,382,61.3,3213,26,6.8,6,1.6,8.4,9.07,13.7,229.5,151.2
Arizona State,2023,12,3,9,0.25,364,1343,3.8,17,111.9,243,2524,10.4,8,210.3,607,3867,6.4,25,243,440,55.5,2524,8,1.8,14,3.2,5.8,4.69,10.4,210.3,103.5
Arizona State,2022,12,3,9,0.25,378,1623,4.3,21,135.3,270,3023,11.2,18,251.9,648,4646,7.2,39,270,403,67.2,3023,18,4.5,9,2.2,7.5,7.41,11.2,251.9,140.6
Arkansas,2024,13,7,6,0.538,485,2402,5.0,34,184.8,255,3570,14.0,16,274.7,740,5973,8.1,50,255,414,61.7,3571,16,3.9,9,2.2,8.6,8.44,14.0,274.7,142.8
Arkansas,2023,12,4,8,0.333,467,1668,3.6,9,139.0,207,2250,10.9,22,187.5,674,3918,5.9,31,207,323,64.1,2250,22,6.8,8,2.5,7.0,7.21,10.9,187.5,140.1
Arkansas,2022,13,7,6,0.538,600,3077,5.2,27,236.7,231,3049,13.2,26,233.8,831,6116,7.4,53,231,357,64.9,3039,26,7.3,7,2.0,8.5,9.11,13.2,233.8,156.8
Arkansas State,2024,13,8,5,0.615,477,2040,4.4,18,156.9,274,2957,10.8,19,227.5,751,4997,6.7,37,274,442,62.0,2957,19,4.3,10,2.3,6.7,6.53,10.8,227.5,127.8
Arkansas State,2023,13,6,7,0.462,452,1919,4.3,20,147.6,208,2938,14.1,17,226.0,660,4857,7.4,37,208,370,56.2,2938,17,4.6,9,2.4,7.9,7.76,14.1,226.0,133.2
Arkansas State,2022,12,3,9,0.25,372,1058,3.0,16,88.2,247,2719,11.0,16,226.6,619,3777,6.2,32,247,396,62.4,2719,16,4.0,5,1.3,6.9,7.11,11.0,226.6,130.9
Army,2024,14,12,2,0.857,748,4207,5.7,48,300.5,66,1128,17.1,10,80.6,814,5335,6.6,58,66,122,54.1,1128,10,8.2,4,3.3,9.2,9.41,17.1,80.6,152.3
Army,2023,12,6,6,0.5,566,2496,4.4,19,208.0,83,1233,14.9,7,102.8,649,3730,5.8,26,83,164,50.6,1234,7,4.3,11,6.7,7.5,5.36,14.9,102.8,114.5
Army,2022,12,6,6,0.5,642,3473,5.5,38,289.4,42,920,21.9,5,76.7,684,4393,6.5,43,42,104,40.4,920,5,4.8,4,3.8,8.8,8.08,21.9,76.7,122.9
Auburn,2024,12,5,7,0.417,399,1986,5.0,13,165.5,230,3167,13.8,27,263.9,629,5153,8.2,40,230,369,62.5,3167,27,7.3,13,3.5,8.6,8.48,13.8,263.9,151.9
Auburn,2023,13,6,7,0.462,501,2457,5.0,22,189.0,189,2109,11.2,18,162.2,690,4566,6.7,40,189,317,59.6,2109,18,5.7,13,4.1,6.7,5.94,11.2,162.2,126.0
Auburn,2022,12,5,7,0.417,481,2470,5.2,25,205.8,159,2072,13.0,9,172.7,640,4542,7.1,34,159,308,51.6,2072,9,2.9,12,3.9,6.7,5.56,13.0,172.7,110.0
BYU,2024,13,11,2,0.846,442,2093,4.8,20,161.0,217,3007,13.9,21,231.3,659,5100,7.8,41,217,379,57.7,3007,21,5.6,14,3.7,8.0,7.44,13.9,231.3,135.9
BYU,2023,12,5,7,0.417,355,1252,3.6,15,104.3,220,2465,11.2,17,205.4,575,3717,6.5,32,220,396,55.7,2465,17,4.3,9,2.3,6.2,6.08,11.2,205.4,117.8
BYU,2022,13,8,5,0.615,427,2296,5.4,19,176.6,257,3246,12.6,32,249.7,684,5542,8.1,51,257,392,65.7,3246,32,8.2,7,1.8,8.3,9.13,12.6,249.7,158.9
Ball State,2024,12,3,9,0.25,369,1234,3.4,10,102.8,280,2940,10.5,26,245.0,649,4174,6.4,36,280,439,63.8,2940,26,5.9,11,2.5,6.7,6.75,10.5,245.0,134.6
Ball State,2023,12,4,8,0.333,469,2058,4.4,15,171.5,180,1639,9.1,9,136.6,649,3697,5.7,24,180,304,59.2,1639,9,3.0,9,3.0,5.4,4.65,9.1,136.6,108.3
Ball State,2022,12,5,7,0.417,408,1868,4.7,14,155.7,287,2742,9.6,18,228.5,695,4610,6.7,32,287,481,59.7,2742,18,3.7,14,2.9,5.7,5.14,9.6,228.5,114.1
Baylor,2024,13,8,5,0.615,484,2324,4.9,25,178.8,253,3397,13.4,31,261.3,737,5721,7.9,56,253,413,61.3,3397,31,7.5,10,2.4,8.2,8.64,13.4,261.3,150.3
Baylor,2023,12,3,9,0.25,407,1378,3.5,13,114.8,263,3156,12.0,15,263.0,670,4534,6.8,28,263,442,59.5,3156,15,3.4,7,1.6,7.1,7.11,12.0,263.0,127.5
Baylor,2022,13,6,7,0.462,525,2371,4.6,34,182.4,247,3009,12.2,19,231.5,772,5380,7.0,53,247,392,63.0,3009,19,4.8,11,2.8,7.7,7.38,12.2,231.5,137.9
Boise State,2024,14,12,2,0.857,538,3365,6.3,43,240.4,261,3159,12.1,23,225.6,799,6524,8.2,66,261,415,62.9,3159,23,5.5,7,1.7,7.6,7.96,12.1,225.6,141.7
Boise State,2023,14,8,6,0.571,551,3008,5.5,34,214.9,216,3098,14.3,20,221.3,767,6106,8.0,54,216,372,58.9,3098,20,5.4,13,3.5,8.4,7.94,14.3,221.3,140.7
Boise State,2022,14,10,4,0.714,536,2751,5.2,27,196.5,229,2668,11.7,20,190.6,765,5419,7.2,47,229,385,59.8,2668,20,5.2,9,2.3,7.0,6.95,11.7,190.6,130.8
Boston College,2024,13,7,6,0.538,512,2159,4.3,24,166.1,207,2591,12.5,24,199.3,719,4750,6.7,48,207,330,62.7,2591,24,7.3,7,2.1,7.9,8.35,12.5,199.3,148.4
Boston College,2023,13,7,6,0.538,531,2584,4.9,25,198.8,204,2372,11.6,15,182.5,735,4956,6.8,40,204,361,56.5,2372,15,4.2,14,3.9,6.6,5.66,11.6,182.5,117.7
Boston College,2022,12,3,9,0.25,357,753,2.2,6,62.8,262,2965,11.3,21,247.1,619,3718,6.1,27,262,440,59.7,2965,21,4.8,14,3.2,6.8,6.28,11.3,247.1,125.8
Bowling Green,2024,13,7,6,0.538,411,1778,4.4,20,136.8,276,3133,11.4,20,240.6,687,4906,7.2,40,276,419,66.0,3128,20,4.8,6,1.4,7.5,7.79,11.3,240.6,141.8
Bowling Green,2023,13,7,6,0.538,418,1788,4.3,22,137.5,213,2454,11.5,17,188.8,631,4242,6.7,39,213,357,59.7,2454,17,4.8,14,3.9,6.9,6.06,11.5,188.8,125.3
Bowling Green,2022,13,6,7,0.462,403,1302,3.4,8,100.2,266,3051,11.5,25,234.7,669,4353,6.6,33,266,438,60.7,3051,25,5.7,11,2.5,7.0,6.98,11.5,234.7,133.1
Buffalo,2024,13,9,4,0.692,521,2198,4.3,24,169.1,194,2422,12.5,19,186.3,715,4620,6.5,43,194,347,55.9,2422,19,5.5,6,1.7,7.0,7.3,12.5,186.3,129.1
Buffalo,2023,12,3,9,0.25,430,1603,3.8,15,133.6,212,2222,10.5,14,185.2,642,3825,6.0,29,212,394,53.8,2222,14,3.6,11,2.8,5.6,5.09,10.5,185.2,107.3
Buffalo,2022,13,7,6,0.538,521,1845,3.6,22,141.9,273,3059,11.2,18,235.3,794,4904,6.2,40,273,463,59.0,3059,18,3.9,8,1.7,6.6,6.61,11.2,235.3,123.8
California,2024,13,6,7,0.462,434,1580,3.7,17,121.5,302,3362,11.1,16,258.6,736,4942,6.7,33,302,464,65.4,3362,16,3.5,7,1.5,7.3,7.29,11.1,258.6,134.9
California,2023,13,6,7,0.462,490,2246,4.6,25,172.8,258,2836,11.0,22,218.2,748,5082,6.8,47,258,434,59.4,2836,22,5.1,16,3.7,6.5,5.89,11.0,218.2,123.7
California,2022,12,4,8,0.333,314,1159,3.7,10,96.6,291,3240,11.1,23,268.0,605,4375,7.3,33,291,466,62.4,3216,23,4.9,9,1.9,7.0,7.07,11.1,268.0,133.3
Central Michigan,2024,12,4,8,0.333,444,1993,4.5,17,166.1,167,1961,11.7,11,163.4,611,3954,6.5,28,167,302,55.5,1961,11,3.7,12,4.0,6.5,5.45,11.7,163.4,114.3
Central Michigan,2023,12,5,7,0.417,454,1913,4.2,21,159.4,183,2216,12.1,15,184.7,637,4129,6.5,36,183,325,56.3,2216,15,4.6,11,3.4,6.8,6.22,12.1,184.7,122.0
Central Michigan,2022,12,4,8,0.333,439,1925,4.4,22,160.4,219,2497,11.4,16,208.1,658,4422,6.7,38,219,387,56.7,2497,16,4.1,10,2.6,6.5,6.13,11.4,208.1,119.6
Cincinnati,2024,12,5,7,0.417,419,2209,5.3,19,184.1,252,2837,11.3,18,236.5,671,5047,7.6,37,252,395,63.8,2838,18,4.6,7,1.8,7.2,7.3,11.3,236.5,135.6
Cincinnati,2023,12,3,9,0.25,513,2605,5.1,14,217.1,218,2508,11.5,21,209.0,731,5113,7.0,35,218,360,60.6,2508,21,5.8,11,3.1,7.0,6.76,11.5,209.0,132.2
Cincinnati,2022,13,9,4,0.692,413,1686,4.1,19,129.7,248,3154,12.7,22,242.7,661,4841,7.4,41,248,415,59.9,3155,22,5.3,8,1.9,7.6,7.81,12.7,242.7,137.6
Clemson,2024,14,10,4,0.714,467,2427,5.2,23,173.4,331,3899,11.8,37,278.5,798,6326,7.9,60,331,533,62.8,3899,37,7.0,7,1.3,7.4,8.2,11.8,278.5,145.5
Clemson,2023,13,9,4,0.692,519,2266,4.4,24,174.3,302,2969,9.8,20,228.4,821,5235,6.4,44,302,474,64.1,2969,20,4.2,9,1.9,6.3,6.29,9.8,228.4,127.3
Clemson,2022,14,11,3,0.786,538,2491,4.7,31,177.9,298,3253,10.9,24,232.4,836,5744,6.9,55,298,480,62.2,3253,24,5.0,10,2.1,6.8,6.85,10.9,232.4,131.6
Colorado,2024,13,9,4,0.692,331,847,2.6,15,65.2,353,4134,11.7,37,318.0,684,4981,7.3,52,353,482,73.4,4134,37,7.7,10,2.1,8.6,9.2,11.7,318.0,166.8
Colorado,2023,12,4,8,0.333,355,827,2.3,12,68.9,323,3536,10.9,29,294.7,678,4363,6.4,41,323,474,68.1,3536,29,6.1,4,0.8,7.5,8.3,10.9,294.7,149.3
Colorado,2022,12,1,11,0.083,381,1300,3.6,11,108.3,179,2075,11.6,10,172.9,560,3375,6.1,21,179,360,49.7,2075,10,2.8,10,2.8,5.8,5.07,11.6,172.9,101.8
Colorado State,2024,13,8,5,0.615,456,2186,4.8,20,168.2,236,2853,12.1,16,219.5,692,5039,7.3,36,236,390,60.5,2853,16,4.1,10,2.6,7.3,6.98,12.1,219.5,130.4
Colorado State,2023,12,5,7,0.417,327,1106,3.5,10,92.2,311,3678,11.8,24,306.5,638,4784,7.5,34,311,501,62.1,3678,24,4.8,18,3.6,7.3,6.68,11.8,306.5,132.4
Colorado State,2022,12,3,9,0.25,382,1068,2.8,4,89.0,203,2361,11.6,12,196.8,585,3429,5.9,16,203,322,63.0,2361,12,3.7,11,3.4,7.3,6.54,11.6,196.8,130.1
Connecticut,2024,13,9,4,0.692,502,2590,5.2,23,199.2,222,2579,11.6,25,198.4,724,5169,7.2,48,222,396,56.1,2579,25,6.3,9,2.3,6.5,6.75,11.6,198.4,127.1
Connecticut,2023,12,3,9,0.25,388,1639,4.3,15,136.6,219,2290,10.5,12,190.3,607,3923,6.5,27,219,381,57.5,2284,12,3.1,7,1.8,6.0,5.8,10.4,190.3,114.6
Connecticut,2022,13,6,7,0.462,513,2483,4.9,20,191.0,157,1455,9.3,10,111.9,670,3938,5.9,30,157,276,56.9,1455,10,3.6,10,3.6,5.3,4.37,9.3,111.9,105.9
Duke,2024,13,9,4,0.692,365,1202,3.4,13,92.5,280,3176,11.3,28,244.3,645,4378,6.8,41,280,467,60.0,3176,28,6.0,13,2.8,6.8,6.75,11.3,244.3,131.3
Duke,2023,13,8,5,0.615,437,2174,5.0,26,167.2,200,2351,11.8,14,180.8,637,4525,7.1,40,200,357,56.3,2351,14,3.9,8,2.3,6.6,6.4,11.8,180.8,120.5
Duke,2022,13,9,4,0.692,469,2394,5.2,31,184.2,255,3010,11.8,20,231.5,724,5404,7.5,51,255,400,64.1,3010,20,5.0,6,1.5,7.6,7.89,11.8,231.5,141.2
East Carolina,2024,13,8,5,0.615,465,2241,4.8,23,172.4,258,3432,13.3,26,264.0,723,5673,7.9,49,258,428,60.4,3432,26,6.1,23,5.4,8.0,6.83,13.3,264.0,137.3
East Carolina,2023,12,2,10,0.167,383,1360,3.6,12,113.3,208,1967,9.5,7,163.9,591,3327,5.6,19,208,388,53.7,1967,7,1.8,14,3.6,5.1,3.82,9.5,163.9,95.2
East Carolina,2022,13,8,5,0.615,417,2218,5.3,25,170.6,323,3776,11.7,28,290.5,740,5994,8.1,53,323,484,67.0,3776,28,5.8,5,1.0,7.8,8.53,11.7,290.5,149.9
Eastern Michigan,2024,12,5,7,0.417,471,1702,3.7,17,141.8,249,2832,11.4,17,236.0,720,4534,6.3,34,249,416,60.0,2832,17,4.1,10,2.4,6.8,6.56,11.4,236.0,126.0
Eastern Michigan,2023,13,6,7,0.462,418,1440,3.5,18,110.8,197,1976,10.0,10,152.0,615,3416,5.6,28,197,358,55.0,1976,10,2.8,12,3.4,5.5,4.57,10.0,152.0,103.9
Eastern Michigan,2022,13,9,4,0.692,488,1830,3.8,25,140.8,244,2911,11.9,23,223.9,732,4741,6.5,48,244,392,62.4,2911,23,5.9,12,3.1,7.4,7.24,11.9,223.9,138.2
Florida,2024,13,8,5,0.615,452,2096,4.7,25,161.2,208,2934,14.1,18,225.7,660,5030,7.7,43,208,342,61.9,2934,18,5.4,14,4.2,8.7,7.93,14.1,225.7,144.6
Florida,2023,12,5,7,0.417,412,1798,4.5,21,149.8,282,3111,11.0,20,259.3,694,4909,7.1,41,282,390,72.3,3111,20,5.1,5,1.3,8.0,8.43,11.0,259.3,153.7
Florida,2022,13,6,7,0.462,460,2603,5.7,29,200.2,199,2910,14.6,18,223.8,659,5513,8.4,47,199,366,54.7,2910,18,4.9,9,2.5,8.0,7.87,14.6,223.8,133.2
Florida Atlantic,2024,12,3,9,0.25,456,2268,5.0,24,189.0,205,2503,12.2,14,208.6,661,4771,7.2,38,205,350,58.7,2503,14,4.0,11,3.2,7.2,6.56,12.2,208.6,125.9
Florida Atlantic,2023,12,4,8,0.333,363,1383,3.8,16,115.3,265,2586,9.8,19,215.5,628,3969,6.3,35,265,412,64.6,2586,19,4.6,15,3.7,6.3,5.59,9.8,215.5,125.6
Florida Atlantic,2022,12,5,7,0.417,483,2212,4.6,19,184.3,217,2726,12.6,25,227.2,700,4938,7.1,44,217,379,57.4,2726,25,6.6,5,1.3,7.2,7.94,12.6,227.2,137.2
Florida International,2024,12,4,8,0.333,386,1447,3.8,16,120.6,206,2753,13.4,24,229.4,592,4200,7.1,40,206,334,61.7,2753,24,7.2,11,3.3,8.2,8.2,13.4,229.4,148.0
Florida International,2023,12,4,8,0.333,371,1083,3.0,17,90.3,220,2779,12.6,12,229.3,591,3835,6.6,29,220,383,57.7,2752,12,3.1,12,3.1,7.2,6.44,12.5,229.3,122.5
Florida International,2022,12,4,8,0.333,346,1260,3.7,11,105.0,271,2625,9.7,16,218.8,617,3885,6.3,27,271,468,58.2,2625,16,3.4,16,3.4,5.6,4.77,9.7,218.8,109.9
Florida State,2024,12,2,10,0.167,372,1079,3.0,8,89.9,179,2164,12.1,11,180.3,551,3243,6.0,19,179,355,50.6,2164,11,3.1,13,3.7,6.1,5.08,12.1,180.3,104.8
Florida State,2023,14,13,1,0.929,445,2103,4.8,32,150.2,260,3519,13.5,25,251.4,705,5622,8.0,57,260,433,60.0,3519,25,5.8,4,0.9,8.1,8.87,13.5,251.4,145.5
Florida State,2022,13,10,3,0.769,502,2783,5.6,33,214.1,249,3512,14.1,28,270.2,751,6295,8.4,61,249,395,63.2,3512,28,7.1,7,1.8,8.9,9.54,14.1,270.2,158.0
Fresno State,2024,13,6,7,0.462,379,1276,3.4,21,98.2,300,3152,10.5,20,242.5,679,4428,6.5,41,300,432,69.6,3152,20,4.6,14,3.2,7.3,6.78,10.5,242.5,139.9
Fresno State,2023,13,9,4,0.692,353,1372,3.9,16,105.5,337,3669,10.9,29,282.2,690,5041,7.3,45,337,518,65.3,3669,29,5.6,12,2.3,7.1,7.19,10.9,282.2,138.9
Fresno State,2022,14,10,4,0.714,454,1851,4.1,28,132.2,336,3788,11.3,22,270.6,790,5639,7.2,50,336,473,71.5,3788,22,4.7,9,1.9,8.1,8.13,11.3,270.6,150.8
Georgia,2024,14,11,3,0.786,416,1742,4.2,24,124.4,336,3934,11.7,29,281.0,752,5676,7.6,53,336,513,65.5,3934,29,5.7,13,2.5,7.7,7.66,11.7,281.0,143.5
Georgia,2023,14,13,1,0.929,484,2677,5.6,40,191.2,328,4274,13.0,29,305.3,812,6951,8.6,69,328,457,71.9,4274,29,6.4,7,1.5,9.4,9.95,13.0,305.3,168.6
Georgia,2022,15,15,0,1.0,535,3080,5.8,44,205.3,336,4438,13.2,31,295.9,871,7518,8.7,75,336,493,68.4,4438,31,6.3,7,1.4,9.0,9.66,13.2,295.9,162.3
Georgia Southern,2024,13,8,5,0.615,436,1659,3.8,24,127.6,289,3091,10.7,21,237.8,725,4750,6.6,45,289,446,65.1,3091,21,4.7,11,2.5,7.0,6.79,10.7,237.8,134.2
Georgia Southern,2023,13,6,7,0.462,372,1524,4.1,16,117.2,376,3929,10.4,26,302.2,748,5453,7.3,42,376,577,65.7,3929,26,4.5,20,3.5,6.9,6.2,10.4,302.2,131.4
Georgia Southern,2022,13,6,7,0.462,366,1779,4.9,23,136.8,374,4289,11.5,28,329.8,740,6067,8.2,51,374,612,61.2,4288,28,4.6,16,2.6,7.0,6.76,11.5,329.8,130.1
Georgia State,2024,12,3,9,0.25,356,1599,4.5,13,133.3,271,3069,11.3,21,255.8,627,4668,7.5,34,271,449,60.4,3069,21,4.7,13,2.9,6.8,6.47,11.3,255.8,127.4
Georgia State,2023,13,7,6,0.538,506,2445,4.9,25,188.1,249,2668,10.7,20,205.2,755,5113,6.8,45,249,367,68.0,2668,20,5.5,7,1.9,7.3,7.52,10.7,205.2,143.5
Georgia State,2022,12,4,8,0.333,566,2561,4.6,26,213.4,174,2443,14.0,18,203.6,740,5004,6.8,44,174,298,58.6,2443,18,6.1,7,2.4,8.2,8.38,14.0,203.6,143.0
Georgia Tech,2024,13,7,6,0.538,485,2431,5.1,29,187.0,269,3088,11.5,17,237.5,754,5519,7.4,46,269,412,65.9,3088,17,4.2,7,1.7,7.6,7.63,11.5,237.5,139.8
Georgia Tech,2023,13,7,6,0.538,483,2649,5.5,24,203.8,231,2871,12.4,27,220.8,714,5520,7.8,51,231,379,61.3,2871,27,7.2,17,4.5,7.6,7.02,12.4,220.8,139.9
Georgia Tech,2022,12,5,7,0.417,419,1592,3.8,13,132.7,219,2306,10.5,10,192.2,638,3898,6.1,23,219,381,57.5,2306,10,2.6,9,2.4,6.1,5.51,10.5,192.2,112.3
Hawaii,2024,12,5,7,0.417,332,1172,3.6,7,97.7,286,3218,11.3,25,268.2,618,4390,7.1,32,286,480,59.6,3218,25,5.2,15,3.1,6.7,6.34,11.3,268.2,126.8
Hawaii,2023,13,5,8,0.385,319,989,3.1,6,76.1,337,3593,10.7,27,276.4,656,4582,7.0,33,337,537,63.0,3593,27,5.0,15,2.8,6.7,6.46,10.7,276.4,130.5
Hawaii,2022,13,3,10,0.231,396,1784,4.5,16,137.2,261,2672,10.2,13,205.5,657,4456,6.8,29,261,490,53.4,2672,13,2.7,12,2.5,5.5,4.89,10.2,205.5,103.1
Houston,2024,12,4,8,0.333,424,1625,3.9,9,135.4,182,1832,10.1,9,152.7,606,3457,5.7,18,182,280,65.0,1832,9,3.2,17,6.1,6.5,4.45,10.1,152.7,118.4
Houston,2023,12,4,8,0.333,355,1424,4.0,10,118.7,261,2898,11.1,24,241.5,616,4322,7.0,34,261,408,64.1,2898,24,5.9,13,3.2,7.1,6.86,11.1,241.5,137.0
Houston,2022,13,8,5,0.615,392,1844,4.7,17,141.8,337,4082,12.1,40,314.0,729,5926,8.1,57,337,500,67.5,4082,40,8.0,10,2.0,8.2,8.88,12.1,314.0,158.7
Illinois,2024,13,10,3,0.769,446,1997,4.5,22,153.6,213,2746,12.9,22,211.2,659,4743,7.2,44,213,353,60.5,2746,22,6.3,6,1.7,7.8,8.28,12.9,211.2,143.3
Illinois,2023,12,5,7,0.417,390,1517,3.9,12,126.4,261,3175,12.2,23,264.6,651,4692,7.2,35,261,415,63.0,3175,23,5.6,13,3.1,7.7,7.37,12.2,264.6,139.5
Illinois,2022,13,8,5,0.615,528,2161,4.2,18,166.2,275,2756,10.0,15,211.8,803,4914,6.2,33,275,395,69.6,2753,15,3.8,5,1.3,7.0,7.16,10.0,211.8,138.2
Indiana,2024,13,11,2,0.846,470,2146,4.7,37,165.1,246,3397,13.8,33,261.3,716,5543,7.8,70,246,361,68.3,3397,33,9.2,6,1.7,9.4,10.52,13.8,261.3,174.5
Indiana,2023,12,3,9,0.25,428,1441,3.4,13,120.1,215,2553,11.9,18,212.8,643,3994,6.2,31,215,367,58.6,2553,18,4.9,10,2.7,7.0,6.71,11.9,212.8,127.8
Indiana,2022,12,4,8,0.333,393,1330,3.4,15,110.8,261,2609,10.0,16,217.4,654,3939,6.0,31,261,483,54.0,2609,16,3.3,13,2.7,5.4,4.85,10.0,217.4,105.0
Iowa,2024,13,8,5,0.615,496,2564,5.2,30,197.2,163,1711,10.5,10,131.6,659,4275,6.5,40,163,260,62.7,1711,10,3.8,8,3.1,6.6,5.97,10.5,131.6,124.5
Iowa,2023,14,10,4,0.714,474,1623,3.5,11,115.9,170,1661,9.8,9,118.6,644,3284,5.1,20,170,348,48.9,1661,9,2.6,11,3.2,4.8,3.87,9.8,118.6,91.2
Iowa,2022,13,8,5,0.615,416,1233,3.0,12,94.8,192,2037,10.6,7,156.7,608,3270,5.4,19,192,349,55.2,2037,7,2.0,7,2.0,5.9,5.35,10.6,156.7,107.0
Iowa State,2024,14,11,3,0.786,509,2247,4.4,27,160.5,277,3580,12.9,25,255.7,786,5827,7.4,52,277,473,59.1,3580,25,5.3,10,2.1,7.6,7.74,12.9,255.7,136.5
Iowa State,2023,13,7,6,0.538,368,1559,4.4,16,119.9,241,3185,13.2,23,245.0,609,4744,7.9,39,241,381,63.4,3185,23,6.1,8,2.1,8.4,8.64,13.2,245.0,149.6
Iowa State,2022,12,4,8,0.333,386,1296,3.5,10,108.0,313,3141,10.0,19,261.8,699,4437,6.4,29,313,479,65.5,3141,19,4.0,15,3.1,6.6,5.95,10.0,261.8,127.5
Kansas,2024,12,5,7,0.417,446,2537,5.7,29,211.4,176,2505,14.2,15,208.8,622,5042,8.1,44,176,306,57.5,2505,15,4.9,12,3.9,8.2,7.4,14.2,208.8,134.6
Kansas,2023,13,9,4,0.692,487,2678,5.6,32,206.0,200,3121,15.6,24,240.1,687,5799,8.5,56,200,311,64.3,3121,24,7.7,11,3.5,10.0,9.99,15.6,240.1,167.0
Kansas,2022,13,6,7,0.462,435,2395,5.5,29,184.2,242,3307,13.7,32,254.4,677,5702,8.4,61,242,371,65.2,3307,32,8.6,8,2.2,8.9,9.67,13.7,254.4,164.3
Kansas State,2024,13,9,4,0.692,447,2801,6.3,21,215.5,222,2748,12.4,25,211.4,669,5549,8.3,46,222,383,58.3,2748,25,6.6,10,2.6,7.2,7.34,12.4,211.4,135.3
Kansas State,2023,13,9,4,0.692,524,2653,5.2,32,204.1,258,3135,12.2,30,241.2,782,5788,7.5,62,258,426,60.7,3135,30,7.1,10,2.4,7.4,7.73,12.2,241.2,141.3
Kansas State,2022,14,10,4,0.714,552,2916,5.3,32,208.3,242,2947,12.2,21,210.5,794,5863,7.4,53,242,389,62.2,2947,21,5.4,6,1.5,7.6,7.96,12.2,210.5,140.6
Kent State,2024,12,0,12,0.0,379,923,2.7,3,76.9,139,1876,13.5,18,156.3,518,2799,5.6,21,139,294,47.3,1876,18,6.1,13,4.4,6.4,5.62,13.5,156.3,112.2
Kent State,2023,12,1,11,0.083,439,1271,2.9,8,105.9,160,1975,12.3,11,164.5,599,3245,5.4,19,160,305,52.5,1974,11,3.6,6,2.0,6.5,6.31,12.3,164.5,114.8
Kent State,2022,12,5,7,0.417,514,2425,4.8,23,202.1,194,2582,13.3,17,215.2,708,5007,7.1,40,194,349,55.6,2582,17,4.9,8,2.3,7.4,7.34,13.3,215.2,129.2
Kentucky,2024,12,4,8,0.333,434,1747,4.1,11,145.6,167,2218,13.3,15,184.8,601,3965,6.6,26,167,312,53.7,2218,15,4.8,17,5.5,7.1,5.64,13.3,184.8,118.6
Kentucky,2023,13,7,6,0.538,332,1662,5.1,18,127.8,211,2751,13.0,25,211.6,543,4413,8.2,43,211,375,56.3,2751,25,6.7,12,3.2,7.3,7.23,13.0,211.6,133.5
Kentucky,2022,13,7,6,0.538,453,1511,3.4,9,116.2,224,2710,12.1,21,208.5,677,4221,6.3,30,224,349,64.2,2710,21,6.0,13,3.7,7.8,7.29,12.1,208.5,141.8
LSU,2024,13,9,4,0.692,365,1513,4.2,15,116.4,344,4097,11.9,29,315.2,709,5610,7.9,44,344,534,64.4,4097,29,5.4,12,2.2,7.7,7.75,11.9,315.2,142.3
LSU,2023,13,10,3,0.769,423,2659,6.3,34,204.5,286,4406,15.4,44,338.9,709,7065,10.0,78,286,411,70.3,4406,44,10.8,5,1.2,10.8,12.43,15.4,338.9,194.4
LSU,2022,14,10,4,0.714,505,2574,5.2,39,183.9,322,3770,11.7,23,269.3,827,6344,7.7,62,322,480,67.4,3770,23,4.8,7,1.5,7.9,8.19,11.7,269.3,146.6
Louisiana,2024,14,10,4,0.714,467,2330,5.0,25,166.4,269,3482,12.9,22,248.7,736,5812,7.9,47,269,412,65.6,3482,22,5.4,9,2.2,8.5,8.58,12.9,248.7,150.3
Louisiana,2023,13,6,7,0.462,461,2284,5.0,25,175.7,238,2817,11.8,23,216.7,699,5101,7.3,48,238,367,64.9,2817,23,6.3,9,2.5,7.7,7.83,11.8,216.7,145.1
Louisiana,2022,13,6,7,0.462,446,1843,4.3,10,141.8,253,2893,11.4,27,222.5,699,4736,6.9,37,253,442,57.2,2893,27,6.1,10,2.3,6.5,6.75,11.4,222.5,127.9
Louisiana Tech,2024,13,5,8,0.385,467,1420,3.2,14,109.2,256,2908,11.4,18,223.7,723,4328,6.1,32,256,413,62.1,2908,18,4.4,8,1.9,7.1,7.06,11.4,223.7,132.0
Louisiana Tech,2023,12,3,9,0.25,377,1485,4.0,20,123.8,269,3131,11.6,16,260.9,646,4616,7.2,36,269,423,63.6,3131,16,3.8,11,2.6,7.4,6.99,11.6,260.9,133.1
Louisiana Tech,2022,12,3,9,0.25,390,1497,3.9,14,124.8,254,3207,12.6,25,267.3,644,4704,7.3,39,254,434,58.5,3207,25,5.8,19,4.4,7.4,6.57,12.6,267.3,130.8
Louisiana-Monroe,2024,12,5,7,0.417,447,2036,4.7,17,169.7,134,1617,12.1,11,134.8,581,3653,6.4,28,134,246,54.5,1617,11,4.5,12,4.9,6.6,5.27,12.1,134.8,114.7
Louisiana-Monroe,2023,12,2,10,0.167,413,1753,4.3,7,146.1,177,2098,11.9,15,174.8,590,3851,6.5,22,177,345,51.5,2098,15,4.4,13,3.8,6.1,5.27,11.9,174.8,109.5
Louisiana-Monroe,2022,12,4,8,0.333,414,1448,3.5,16,120.7,221,2464,11.1,16,205.3,635,3912,6.2,32,221,332,67.2,2464,16,4.9,7,2.1,7.5,7.5,11.1,205.3,141.9
Louisville,2024,13,9,4,0.692,417,2407,5.9,28,185.2,271,3433,12.7,26,264.1,688,5840,8.6,54,271,427,63.6,3433,26,6.1,6,1.4,8.1,8.65,12.7,264.1,148.6
Louisville,2023,14,10,4,0.714,519,2499,4.8,31,178.5,266,3313,12.5,22,236.6,785,5812,7.4,53,266,408,65.2,3313,22,5.4,12,2.9,8.1,7.88,12.5,236.6,145.3
Louisville,2022,13,8,5,0.615,511,2608,5.1,25,200.6,218,2672,12.3,13,205.5,729,5280,7.3,38,218,368,59.2,2672,13,3.5,12,3.3,7.3,6.5,12.3,205.5,125.4
Marshall,2024,13,10,3,0.769,495,2622,5.4,21,201.7,194,2354,12.1,27,181.1,689,4976,7.3,48,194,333,58.3,2354,27,8.1,4,1.2,7.1,8.15,12.1,181.1,142.0
Marshall,2023,13,6,7,0.462,441,1720,3.9,21,132.3,268,2940,11.0,12,226.2,709,4660,6.6,33,268,426,62.9,2940,12,2.8,18,4.2,6.9,5.56,11.0,226.2,121.7
Marshall,2022,13,9,4,0.692,589,2677,4.6,20,205.9,225,2496,11.1,16,192.0,814,5173,6.4,36,225,367,61.8,2496,16,4.4,10,2.7,6.9,6.5,11.1,192.0,128.4
Maryland,2024,12,4,8,0.333,363,1325,3.7,15,110.4,315,3308,10.5,21,275.7,678,4633,6.9,36,315,494,64.2,3308,21,4.3,14,2.9,6.7,6.31,10.5,275.7,129.2
Maryland,2023,13,8,5,0.615,377,1409,3.7,20,108.4,307,3626,11.8,27,278.9,684,5035,7.4,47,307,477,64.4,3626,27,5.7,13,2.7,7.6,7.51,11.8,278.9,141.4
Maryland,2022,13,8,5,0.615,459,1837,4.1,23,141.3,294,3383,11.5,21,260.2,753,5220,7.0,44,294,446,65.9,3383,21,4.7,8,1.8,7.6,7.72,11.5,260.2,141.6
Massachusetts,2024,12,2,10,0.167,480,1962,4.1,18,163.5,187,2181,11.7,14,181.8,667,4143,6.2,32,187,327,57.2,2181,14,4.3,6,1.8,6.7,6.7,11.7,181.8,123.7
Massachusetts,2023,12,3,9,0.25,388,1706,4.4,19,142.2,212,2569,12.1,14,214.1,600,4275,7.1,33,212,348,60.9,2569,14,4.0,11,3.2,7.4,6.76,12.1,214.1,129.9
Massachusetts,2022,12,1,11,0.083,515,1786,3.5,10,148.8,136,1403,10.3,4,116.9,651,3189,4.9,14,136,277,49.1,1403,4,1.4,14,5.1,5.1,3.08,10.3,116.9,86.3
Memphis,2024,13,11,2,0.846,440,2263,5.2,33,174.1,310,3516,11.3,25,270.5,750,5779,7.7,58,310,479,64.7,3516,25,5.2,6,1.3,7.3,7.82,11.3,270.5,141.1
Memphis,2023,13,10,3,0.769,421,1976,4.8,31,152.0,321,3984,12.4,33,306.5,742,5960,8.1,64,321,481,66.7,3984,33,6.9,10,2.1,8.3,8.72,12.4,306.5,154.8
Memphis,2022,13,7,6,0.538,484,1849,3.9,30,142.2,290,3629,12.5,23,279.2,774,5478,7.1,53,290,454,64.0,3629,23,5.1,8,1.8,8.0,8.23,12.5,279.2,144.5
Miami (FL),2024,13,10,3,0.769,425,2456,5.8,30,188.9,328,4527,13.8,41,348.2,753,6983,9.3,71,328,489,67.1,4527,41,8.4,8,1.6,9.3,10.2,13.8,348.2,169.2
Miami (FL),2023,13,7,6,0.538,437,2251,5.2,24,173.2,283,3354,11.9,23,258.0,720,5605,7.8,47,283,436,65.1,3354,23,5.3,14,3.2,7.7,7.32,11.9,258.0,140.8
Miami (FL),2022,12,5,7,0.417,408,1535,3.8,12,127.9,255,2868,11.2,18,239.0,663,4403,6.7,30,255,413,61.7,2868,18,4.4,12,2.9,6.9,6.51,11.2,239.0,128.6
Miami (OH),2024,14,9,5,0.643,400,1894,4.8,14,135.3,225,3044,13.5,23,217.4,625,4938,7.9,37,225,399,56.5,3044,23,5.8,12,3.0,7.6,7.45,13.5,217.4,133.8
Miami (OH),2023,14,11,3,0.786,474,2213,4.8,23,158.1,165,2316,14.0,16,165.4,639,4529,7.2,39,165,293,56.3,2316,16,5.5,7,2.4,7.9,7.92,14.0,165.4,136.0
Miami (OH),2022,13,6,7,0.462,468,1821,4.0,14,140.1,184,2152,11.7,15,165.5,652,3973,6.2,29,184,337,54.6,2152,15,4.5,5,1.5,6.4,6.61,11.7,165.5,120.0
Michigan,2024,13,8,5,0.615,477,2043,4.3,18,157.2,190,1678,8.8,12,129.1,667,3721,5.6,30,190,308,61.7,1678,12,3.9,13,4.2,5.4,4.33,8.8,129.1,111.9
Michigan,2023,15,15,0,1.0,550,2536,4.7,40,169.1,260,3205,12.3,24,213.7,810,5741,7.1,64,260,361,72.2,3205,24,6.7,5,1.4,8.9,9.61,12.3,213.7,166.2
Michigan,2022,14,13,1,0.929,589,3345,5.7,41,238.9,238,3078,12.9,24,219.9,827,6423,7.8,65,238,370,64.5,3078,24,6.5,6,1.6,8.3,8.91,12.9,219.9,152.8
Michigan State,2024,12,5,7,0.417,382,1396,3.8,11,116.3,212,2617,12.3,13,218.1,594,4013,6.8,24,212,353,60.1,2617,13,3.7,12,3.4,7.4,6.62,12.3,218.1,127.7
Michigan State,2023,12,4,8,0.333,366,1074,3.0,7,89.5,221,2398,10.9,14,199.8,587,3472,6.0,21,221,379,58.5,2398,14,3.7,13,3.4,6.3,5.54,10.9,199.8,117.1
Michigan State,2022,12,5,7,0.417,356,1356,3.9,16,113.0,258,2880,11.2,23,240.0,614,4236,6.9,39,258,412,62.9,2880,23,5.6,12,2.9,7.0,6.83,11.2,240.0,134.6
Middle Tennessee State,2024,12,3,9,0.25,331,1068,3.3,10,89.0,273,3133,11.5,16,261.1,604,4201,7.0,26,273,428,63.9,3133,16,3.7,10,2.3,7.3,7.03,11.5,261.1,133.2
Middle Tennessee State,2023,12,4,8,0.333,380,1501,4.0,13,125.1,295,3192,10.8,23,266.0,675,4693,7.0,36,295,438,67.4,3192,23,5.3,13,3.0,7.3,7.0,10.8,266.0,140.0
Middle Tennessee State,2022,13,8,5,0.615,442,1411,3.3,20,108.5,341,3442,10.1,21,264.8,783,4853,6.3,41,341,512,66.7,3442,21,4.1,11,2.2,6.7,6.59,10.1,264.8,132.6
Minnesota,2024,13,8,5,0.615,399,1503,3.8,18,115.6,273,2888,10.6,20,222.2,672,4391,6.5,38,273,412,66.7,2888,20,4.9,6,1.5,7.1,7.38,10.6,222.2,139.3
Minnesota,2023,13,6,7,0.462,494,2048,4.2,13,157.5,164,1864,11.4,16,143.4,658,3912,6.0,29,164,312,52.7,1864,16,5.1,11,3.5,6.0,5.43,11.4,143.4,113.0
Minnesota,2022,13,9,4,0.692,573,2695,4.7,33,207.3,172,2369,13.8,12,182.2,745,5064,6.8,45,172,281,61.6,2369,12,4.3,9,3.2,8.5,7.9,13.8,182.2,140.7
Mississippi State,2024,12,2,10,0.167,416,1655,4.0,19,137.9,215,2871,13.4,19,239.3,631,4526,7.2,38,215,368,58.6,2871,19,5.2,8,2.2,7.8,7.88,13.4,239.3,137.0
Mississippi State,2023,12,5,7,0.417,393,1761,4.5,12,146.8,201,2182,10.9,15,181.8,594,3943,6.7,27,201,348,57.8,2182,15,4.3,10,2.9,6.3,5.84,10.9,181.8,118.9
Mississippi State,2022,13,9,4,0.692,289,1062,3.8,12,81.7,428,4046,9.5,36,311.2,717,5108,7.2,48,428,634,68.2,4046,36,5.7,9,1.4,6.4,6.94,9.5,311.2,138.3
Missouri,2024,13,10,3,0.769,509,2138,4.2,26,164.5,250,2926,11.7,14,225.1,759,5064,6.7,40,250,404,61.9,2926,14,3.5,5,1.2,7.2,7.38,11.7,225.1,131.7
Missouri,2023,13,11,2,0.846,479,2236,4.8,25,172.0,248,3410,13.8,23,262.3,727,5646,7.8,48,248,378,66.0,3410,23,6.1,7,1.9,9.1,9.45,13.8,262.3,158.6
Missouri,2022,13,6,7,0.462,481,2024,4.3,20,155.7,251,2783,11.1,14,214.1,732,4807,6.6,34,251,396,63.9,2783,14,3.6,9,2.3,7.1,6.76,11.1,214.1,130.5
Navy,2024,13,10,3,0.769,578,3218,5.6,38,247.5,99,1609,16.3,15,123.8,677,4827,7.2,53,99,179,55.3,1609,15,8.4,6,3.4,9.0,9.16,16.3,123.8,151.8
Navy,2023,12,5,7,0.417,536,2335,4.4,16,194.6,102,1268,12.4,10,105.7,638,3603,5.7,26,102,199,51.5,1268,10,5.1,5,2.5,6.4,6.28,12.4,105.7,116.9
Navy,2022,12,4,8,0.333,705,2894,4.1,22,241.2,54,1028,19.0,9,85.7,759,3922,5.2,31,54,126,45.4,1028,9,7.6,6,5.0,8.6,7.88,19.0,85.7,132.8
Nebraska,2024,13,7,6,0.538,437,1698,3.9,22,130.6,288,2969,10.3,13,228.4,725,4667,6.5,35,288,435,66.5,2969,13,3.0,12,2.8,6.9,6.21,10.3,228.4,128.5
Nebraska,2023,12,5,7,0.417,471,2122,4.5,16,176.8,136,1631,12.0,10,135.9,607,3753,6.2,26,136,261,52.1,1631,10,3.8,16,6.1,6.2,4.26,12.0,135.9,105.0
Nebraska,2022,12,4,8,0.333,410,1480,3.7,17,123.3,205,2650,12.9,17,220.8,615,4130,6.7,34,205,340,60.3,2650,17,5.0,13,3.8,7.8,7.07,12.9,220.8,134.6
Nevada,2024,13,3,10,0.231,459,2125,4.7,21,163.5,247,2764,11.2,19,212.6,706,4889,6.9,40,247,366,67.9,2764,19,5.2,8,2.2,7.6,7.65,11.2,212.6,144.5
Nevada,2023,12,2,10,0.167,436,1498,3.5,13,124.8,191,2102,11.0,6,175.2,627,3600,5.8,19,191,345,55.4,2102,6,1.7,12,3.5,6.1,4.88,11.0,175.2,105.3
Nevada,2022,12,2,10,0.167,420,1421,3.5,19,118.4,217,2227,10.3,7,185.6,637,3648,5.8,26,217,398,54.7,2227,7,1.8,8,2.0,5.6,5.06,10.3,185.6,103.6
Nevada-Las Vegas,2024,14,11,3,0.786,605,3409,5.7,29,243.5,178,2417,13.6,25,172.6,783,5826,7.5,54,178,309,57.8,2417,25,8.1,6,1.9,7.8,8.59,13.6,172.6,146.6
Nevada-Las Vegas,2023,14,9,5,0.643,533,2429,4.6,39,173.5,251,3349,13.3,17,239.2,784,5778,7.4,56,251,404,62.1,3349,17,4.2,12,3.0,8.3,7.79,13.3,239.2,139.7
Nevada-Las Vegas,2022,12,5,7,0.417,398,1645,4.2,18,137.1,227,2580,11.4,15,215.0,625,4225,6.8,33,227,361,62.9,2580,15,4.2,7,1.9,7.1,7.11,11.4,215.0,132.7
New Mexico,2024,12,5,7,0.417,449,3043,6.8,37,253.6,226,2768,12.2,12,230.7,675,5811,8.6,49,226,390,57.9,2768,12,3.1,12,3.1,7.1,6.33,12.2,230.7,121.6
New Mexico,2023,12,4,8,0.333,437,2312,5.3,26,192.7,198,2615,13.2,17,217.9,635,4927,7.8,43,198,353,56.4,2615,17,4.8,10,2.8,7.5,7.14,13.2,217.9,129.3
New Mexico,2022,12,2,10,0.167,436,1478,3.4,12,123.2,137,1259,9.2,3,104.9,573,2737,4.8,15,137,255,53.9,1259,3,1.2,9,3.5,5.0,3.6,9.2,104.9,92.4
New Mexico State,2024,12,3,9,0.25,491,2160,4.4,16,180.0,141,1718,12.2,12,143.2,632,3878,6.2,28,141,320,44.1,1718,12,3.8,12,3.8,5.4,4.43,12.2,143.2,94.0
New Mexico State,2023,15,10,5,0.667,514,2980,5.8,22,198.7,235,3206,13.6,28,213.7,749,6186,8.3,50,235,393,59.8,3206,28,7.1,10,2.5,8.2,8.44,13.6,213.7,146.7
New Mexico State,2022,13,7,6,0.538,442,2099,4.8,25,161.5,159,2199,13.8,18,169.2,601,4298,7.2,43,159,305,52.3,2199,18,5.9,13,4.3,7.2,6.49,13.8,169.2,124.1
North Carolina,2024,13,6,7,0.462,493,2370,4.8,26,182.3,230,2911,12.7,18,224.4,723,5287,7.3,44,230,392,58.8,2917,18,4.6,9,2.3,7.5,7.35,12.7,224.4,132.1
North Carolina,2023,13,8,5,0.615,489,2497,5.1,28,192.1,292,3889,13.3,26,299.2,781,6386,8.2,54,292,460,63.5,3889,26,5.7,11,2.4,8.5,8.51,13.3,299.2,148.4
North Carolina,2022,14,9,5,0.643,496,2149,4.4,24,153.5,344,4330,12.6,38,309.3,840,6479,7.7,62,344,526,65.6,4330,38,7.3,7,1.3,8.3,9.11,12.6,309.3,156.3
North Carolina State,2024,13,6,7,0.462,415,1887,4.6,21,145.2,255,3024,11.9,21,232.6,670,4911,7.3,42,255,391,65.2,3024,21,5.4,13,3.3,7.7,7.31,11.9,232.6,141.3
North Carolina State,2023,13,9,4,0.692,472,2034,4.3,19,156.5,224,2521,11.3,19,193.9,696,4555,6.6,38,224,379,59.3,2521,19,5.0,12,3.2,6.7,6.25,11.3,193.9,125.5
North Carolina State,2022,13,8,5,0.615,430,1479,3.6,8,113.8,269,2939,10.9,23,226.1,699,4418,6.4,31,269,471,57.4,2939,23,4.9,8,1.7,6.3,6.48,10.9,226.1,122.8
North Texas,2024,13,6,7,0.462,372,2088,5.8,24,160.6,353,4267,12.1,33,328.2,725,6355,8.8,57,353,562,63.1,4267,33,5.9,14,2.5,7.6,7.69,12.1,328.2,141.7
North Texas,2023,12,5,7,0.417,445,2294,5.2,19,191.2,284,3656,12.9,33,304.7,729,5950,8.2,52,284,462,61.6,3656,33,7.2,9,2.0,7.9,8.48,12.9,304.7,147.9
North Texas,2022,14,7,7,0.5,528,2798,5.3,24,199.9,241,3667,15.2,34,261.9,769,6465,8.4,58,241,432,56.0,3667,34,7.9,16,3.7,8.5,8.43,15.2,261.9,146.3
Northern Illinois,2024,13,8,5,0.615,549,2649,4.8,22,203.8,216,2320,10.7,16,178.5,765,4969,6.5,38,216,371,58.5,2320,16,4.3,8,2.2,6.3,6.18,10.7,178.5,121.3
Northern Illinois,2023,13,7,6,0.538,456,2335,5.1,23,179.6,211,2460,11.7,15,189.8,667,4802,7.2,38,211,366,58.1,2467,15,4.1,9,2.5,6.8,6.51,11.7,189.8,123.9
Northern Illinois,2022,12,3,9,0.25,473,2285,4.9,19,190.4,185,2192,11.8,18,182.7,658,4477,6.8,37,185,328,56.4,2192,18,5.5,14,4.3,6.7,5.86,11.8,182.7,122.1
Northwestern,2024,12,4,8,0.333,345,1182,3.5,12,98.5,210,2231,10.6,7,185.9,555,3413,6.2,19,210,391,53.7,2231,7,1.8,11,2.8,5.7,4.8,10.6,185.9,101.9
Northwestern,2023,13,8,5,0.615,443,1325,3.1,13,101.9,241,2626,10.9,20,202.0,684,3951,5.8,33,241,389,62.8,2626,20,5.2,8,2.1,6.8,6.94,10.9,202.0,133.2
Northwestern,2022,12,1,11,0.083,457,1501,3.4,11,125.1,245,2524,10.3,10,210.3,702,4025,5.8,21,245,417,58.8,2524,10,2.4,17,4.1,6.1,4.7,10.3,210.3,109.4
Notre Dame,2024,16,14,2,0.875,555,3215,5.8,45,200.9,296,3170,10.7,24,198.1,851,6385,7.5,69,296,445,67.0,3170,24,5.4,8,1.8,7.2,7.44,10.7,198.1,141.5
Notre Dame,2023,13,10,3,0.769,449,2414,5.4,28,185.7,227,3205,14.1,31,246.5,676,5619,8.3,59,227,351,65.4,3205,31,8.9,9,2.6,9.2,9.86,14.1,246.5,167.3
Notre Dame,2022,13,9,4,0.692,519,2458,4.8,25,189.1,211,2692,12.8,25,207.1,730,5150,7.1,50,211,338,62.4,2692,25,7.4,11,3.3,8.0,7.98,12.8,207.1,147.2
Ohio,2024,14,11,3,0.786,555,2984,5.5,35,213.1,217,2694,12.4,15,192.4,772,5678,7.4,50,217,345,63.1,2694,15,4.4,12,3.5,7.8,7.13,12.4,192.4,136.3
Ohio,2023,13,10,3,0.769,469,1877,4.1,18,144.4,239,2647,11.1,16,203.6,708,4524,6.5,34,239,383,62.4,2647,16,4.2,9,2.3,6.9,6.69,11.1,203.6,129.5
Ohio,2022,14,10,4,0.714,479,2003,4.3,23,143.1,302,3894,12.9,28,278.1,781,5897,7.6,51,302,464,65.1,3894,28,6.0,5,1.1,8.4,9.11,12.9,278.1,153.3
Ohio State,2024,16,14,2,0.875,523,2662,5.1,34,166.4,325,4208,12.9,37,263.0,848,6870,8.1,71,325,455,71.4,4208,37,8.1,10,2.2,9.2,9.89,12.9,263.0,171.6
Ohio State,2023,13,11,2,0.846,425,1805,4.3,20,138.8,255,3498,13.7,26,269.1,680,5303,7.8,46,255,400,63.9,3498,26,6.5,7,1.8,8.8,9.28,13.7,269.1,155.5
Ohio State,2022,13,11,2,0.846,455,2501,5.5,30,192.4,274,3878,14.2,42,298.3,729,6379,8.8,72,274,410,67.0,3878,42,10.3,6,1.5,9.5,10.88,14.2,298.3,177.6
Oklahoma,2024,13,6,7,0.462,515,2017,4.0,17,155.2,235,2286,9.7,16,175.8,750,4303,5.8,33,235,373,63.0,2286,16,4.3,6,1.6,6.1,6.26,9.7,175.8,125.4
Oklahoma,2023,13,10,3,0.769,506,2368,4.7,32,182.2,310,4223,13.6,34,324.8,816,6591,8.1,66,310,453,68.4,4223,34,7.5,9,2.0,9.3,9.93,13.6,324.8,167.5
Oklahoma,2022,13,6,7,0.462,570,2852,5.1,28,219.4,251,3310,13.2,27,254.6,821,6162,7.5,55,251,407,61.8,3310,27,6.7,8,2.0,8.2,8.6,13.2,254.6,148.3
Oklahoma State,2024,12,3,9,0.25,350,1341,4.0,19,111.8,267,3147,11.8,21,262.3,617,4488,7.4,40,267,449,59.5,3147,21,4.7,17,3.8,7.0,6.24,11.8,262.3,126.2
Oklahoma State,2023,14,10,4,0.714,431,2174,5.2,29,155.3,344,3871,11.3,18,276.5,775,6045,7.9,47,344,570,60.4,3871,18,3.2,16,2.8,6.8,6.16,11.3,276.5,122.2
Oklahoma State,2022,13,7,6,0.538,460,1632,3.6,20,125.5,292,3634,12.4,24,279.5,752,5266,7.0,44,292,524,55.7,3634,24,4.6,18,3.4,6.9,6.31,12.4,279.5,122.2
Old Dominion,2024,12,5,7,0.417,474,2517,5.3,27,209.8,195,2315,11.9,17,192.9,669,4832,7.2,44,195,333,58.6,2315,17,5.1,9,2.7,7.0,6.76,11.9,192.9,128.4
Old Dominion,2023,13,6,7,0.462,468,1994,4.3,15,153.4,204,2532,12.4,20,194.8,672,4526,6.8,35,204,361,56.7,2532,20,5.6,11,3.1,7.0,6.77,12.4,194.8,128.0
Old Dominion,2022,12,3,9,0.25,308,1107,3.7,8,92.3,237,2966,12.5,19,247.2,545,4073,7.5,27,237,421,56.4,2966,19,4.5,7,1.7,7.1,7.22,12.5,247.2,127.3
Ole Miss,2024,13,10,3,0.769,496,2284,4.6,29,175.7,295,4561,15.5,31,350.8,791,6845,8.7,60,295,434,68.1,4561,31,7.2,7,1.6,10.5,11.24,15.5,350.8,177.0
Ole Miss,2023,13,11,2,0.846,529,2292,4.3,29,176.3,256,3713,14.5,26,285.6,785,6005,7.7,55,256,394,65.1,3713,26,6.6,6,1.5,9.4,10.08,14.5,285.6,163.3
Ole Miss,2022,13,8,5,0.615,605,3336,5.5,33,256.6,239,3117,13.0,22,239.8,844,6453,7.7,55,239,387,61.8,3117,22,5.7,12,3.1,8.1,7.8,13.0,239.8,142.0
Oregon,2024,14,13,1,0.929,483,2211,4.6,30,157.9,335,3913,11.7,30,279.5,818,6124,7.5,60,335,460,73.1,3913,30,6.6,6,1.3,8.5,9.26,11.7,279.5,163.9
Oregon,2023,14,12,2,0.857,423,2583,6.2,33,184.5,397,4857,12.2,49,346.9,820,7440,9.1,82,397,514,77.2,4857,49,9.5,5,1.0,9.4,10.92,12.2,346.9,186.1
Oregon,2022,13,10,3,0.769,496,2805,5.7,34,215.8,308,3702,12.0,30,284.8,804,6507,8.1,64,308,432,71.3,3702,30,6.9,9,2.1,8.6,9.02,12.0,284.8,162.0
Oregon State,2024,12,5,7,0.417,477,2270,4.8,29,189.2,216,2417,11.2,7,201.4,693,4687,6.8,36,216,360,60.0,2417,7,1.9,11,3.1,6.7,5.73,11.2,201.4,116.7
Oregon State,2023,13,8,5,0.615,431,2172,5.2,26,167.1,222,3148,14.2,26,242.2,653,5320,8.2,52,222,380,58.4,3148,26,6.8,8,2.1,8.3,8.71,14.2,242.2,146.4
Oregon State,2022,13,10,3,0.769,503,2554,5.2,36,196.5,201,2594,12.9,16,199.5,704,5148,7.4,52,201,322,62.4,2594,16,5.0,13,4.0,8.1,7.23,12.9,199.5,138.4
Penn State,2024,16,13,3,0.813,609,3237,5.3,35,202.3,292,3646,12.5,30,227.9,901,6883,7.7,65,292,437,66.8,3646,30,6.9,10,2.3,8.3,8.69,12.5,227.9,155.0
Penn State,2023,13,10,3,0.769,512,2403,4.7,26,184.8,246,2795,11.4,30,215.0,758,5198,6.9,56,246,413,59.6,2795,30,7.3,2,0.5,6.8,8.0,11.4,215.0,139.4
Penn State,2022,13,11,2,0.846,477,2354,5.0,28,181.1,270,3283,12.2,29,252.5,747,5637,7.6,57,270,422,64.0,3283,29,6.9,7,1.7,7.8,8.41,12.2,252.5,148.7
Pitt,2024,13,7,6,0.538,417,1843,4.4,16,141.8,302,3467,11.5,29,266.9,719,5313,7.4,45,302,500,60.4,3470,29,5.8,16,3.2,6.9,6.66,11.5,266.9,131.4
Pitt,2023,12,3,9,0.25,348,1223,3.6,10,101.9,192,2592,13.5,17,216.0,540,3815,7.1,27,192,360,53.6,2592,17,4.7,12,3.4,7.2,6.68,13.5,216.0,123.4
Pitt,2022,13,9,4,0.692,501,2379,4.9,30,183.0,223,2896,13.0,13,222.8,724,5275,7.4,43,223,391,57.0,2896,13,3.3,11,2.8,7.4,6.81,13.0,222.8,124.6
Purdue,2024,12,1,11,0.083,344,1384,4.0,9,115.3,189,2207,11.7,13,183.9,533,3591,6.8,22,189,329,57.6,2207,13,4.0,9,2.7,6.7,6.29,11.7,183.9,121.7
Purdue,2023,12,4,8,0.333,456,2029,4.5,20,169.1,234,2534,10.8,15,211.2,690,4563,6.6,35,234,392,59.7,2534,15,3.8,10,2.6,6.5,6.08,10.8,211.2,121.5
Purdue,2022,14,8,6,0.571,456,1694,3.7,17,121.0,369,3903,10.6,26,278.8,825,5597,6.8,43,369,583,63.3,3903,26,4.5,17,2.9,6.7,6.27,10.6,278.8,128.4
Rice,2024,12,4,8,0.333,297,1367,4.6,14,113.9,293,2868,9.8,17,239.0,590,4235,7.2,31,293,478,61.3,2868,17,3.6,13,2.7,6.0,5.49,9.8,239.0,118.0
Rice,2023,13,6,7,0.462,373,1436,3.9,21,110.5,268,3282,12.2,29,252.5,641,4718,7.4,50,268,431,62.3,3282,29,6.7,16,3.7,7.6,7.31,12.2,252.5,141.3
Rice,2022,13,5,8,0.385,457,1839,4.0,17,141.5,233,3028,13.0,23,232.9,690,4867,7.1,40,233,403,58.0,3028,23,5.7,20,5.0,7.5,6.44,13.0,232.9,130.2
Rutgers,2024,13,7,6,0.538,511,2279,4.5,28,175.3,213,2696,12.7,18,207.4,724,4975,6.9,46,213,395,53.9,2696,18,4.6,7,1.8,6.8,6.94,12.7,207.4,122.8
Rutgers,2023,13,7,6,0.538,504,2193,4.5,24,168.7,142,1788,12.6,10,137.5,646,3981,6.3,34,142,294,48.3,1788,10,3.4,8,2.7,6.1,5.54,12.6,137.5,105.2
Rutgers,2022,12,4,8,0.333,423,1533,3.7,11,127.8,168,1847,11.0,11,153.9,591,3380,5.8,22,168,332,50.6,1847,11,3.3,14,4.2,5.6,4.33,11.0,153.9,99.8
SMU,2024,14,11,3,0.786,528,2347,4.6,29,167.6,278,3666,13.2,28,261.9,806,6013,7.5,57,278,436,63.9,3666,28,6.4,12,2.8,8.4,8.47,13.2,261.9,150.4
SMU,2023,14,11,3,0.786,540,2463,4.7,29,175.9,274,3897,14.2,33,278.4,814,6360,7.9,62,274,465,59.2,3897,33,7.1,8,1.7,8.4,9.06,14.2,278.4,149.9
SMU,2022,13,7,6,0.538,483,2030,4.3,26,156.2,333,4117,12.4,36,316.7,816,6147,7.6,62,333,513,64.9,4117,36,7.0,11,2.1,8.0,8.46,12.4,316.7,151.2
San Diego State,2024,12,3,9,0.25,423,1547,3.7,13,128.9,234,2484,10.6,15,205.7,657,4015,6.1,28,234,375,62.4,2468,15,4.0,8,2.1,6.6,6.42,10.5,205.7,126.6
San Diego State,2023,12,4,8,0.333,445,1851,4.2,16,154.3,202,2061,10.2,10,171.8,647,3912,6.1,26,202,319,63.5,2061,10,3.1,10,3.1,6.5,5.69,10.2,171.8,122.1
San Diego State,2022,13,7,6,0.538,463,1864,4.0,11,143.4,186,2360,12.7,15,181.5,649,4224,6.5,26,186,343,54.4,2360,15,4.4,14,4.1,6.9,5.94,12.7,181.5,118.6
San Jose State,2024,13,7,6,0.538,304,1145,3.9,13,88.1,316,4182,13.2,31,321.8,620,5328,8.7,44,316,552,57.5,4183,31,5.6,16,2.9,7.6,7.42,13.2,321.8,134.1
San Jose State,2023,13,7,6,0.538,412,2393,5.9,31,184.1,230,2853,12.4,21,219.5,642,5246,8.2,52,230,375,61.5,2853,21,5.6,4,1.1,7.6,8.27,12.4,219.5,142.0
San Jose State,2022,12,7,5,0.583,336,1149,3.5,19,95.8,260,3270,12.6,23,272.5,596,4419,7.4,42,260,431,60.5,3270,23,5.3,7,1.6,7.6,7.94,12.6,272.5,138.7
South Alabama,2024,13,7,6,0.538,435,2583,6.0,32,198.7,254,3165,12.5,21,243.5,689,5748,8.4,53,254,391,65.0,3165,21,5.4,6,1.5,8.1,8.48,12.5,243.5,147.6
South Alabama,2023,13,7,6,0.538,465,2236,4.8,28,172.0,291,3486,12.0,28,268.2,756,5722,7.6,56,291,428,68.0,3486,28,6.5,11,2.6,8.1,8.3,12.0,268.2,152.9
South Alabama,2022,13,10,3,0.769,493,2038,4.2,19,156.8,290,3479,12.0,28,267.6,783,5517,7.1,47,290,446,65.2,3479,28,6.3,12,2.7,7.8,7.86,12.0,267.6,146.2
South Carolina,2024,13,9,4,0.692,538,2397,4.5,26,184.4,224,2904,13.0,21,223.4,762,5301,7.0,47,224,342,65.9,2904,21,6.2,7,2.1,8.5,8.85,13.0,223.4,153.9
South Carolina,2023,12,5,7,0.417,357,1021,3.0,17,85.1,283,3336,11.8,21,278.0,640,4357,6.9,38,283,412,68.9,3336,21,5.1,8,1.9,8.1,8.26,11.8,278.0,150.0
South Carolina,2022,13,8,5,0.615,404,1545,3.9,27,118.8,281,3380,12.0,23,260.0,685,4925,7.2,50,281,421,66.9,3380,23,5.5,14,3.3,8.0,7.64,12.0,260.0,145.9
South Florida,2024,13,7,6,0.538,488,2343,4.8,34,180.2,262,2957,11.3,16,227.5,750,5300,7.1,50,262,443,59.7,2957,16,3.6,10,2.3,6.7,6.44,11.3,227.5,123.7
South Florida,2023,13,7,6,0.538,573,2377,4.2,23,182.8,287,3494,12.2,27,268.8,860,5871,6.8,50,287,448,64.1,3494,27,6.0,11,2.5,7.8,7.9,12.2,268.8,144.6
South Florida,2022,12,1,11,0.083,437,2374,5.5,25,197.8,188,2315,12.3,18,192.9,625,4689,7.5,43,188,326,57.7,2315,18,5.5,9,2.8,7.1,6.96,12.3,192.9,130.0
Southern Mississippi,2024,12,1,11,0.083,409,1303,3.2,13,108.6,166,2099,12.6,7,174.9,575,3402,5.9,20,166,317,52.4,2099,7,2.2,17,5.4,6.6,4.65,12.6,174.9,104.5
Southern Mississippi,2023,12,3,9,0.25,482,1953,4.1,16,162.8,188,2288,12.2,15,190.7,670,4241,6.3,31,188,363,51.8,2288,15,4.1,8,2.2,6.3,6.14,12.2,190.7,114.0
Southern Mississippi,2022,13,7,6,0.538,465,1843,4.0,15,141.8,191,2698,14.1,20,207.5,656,4541,7.0,35,191,347,55.0,2698,20,5.8,14,4.0,7.8,7.11,14.1,207.5,131.3
Stanford,2024,12,3,9,0.25,434,1592,3.7,11,132.7,224,2295,10.2,18,191.3,658,3887,5.9,29,224,370,60.7,2295,18,4.9,17,4.6,6.2,5.12,10.2,191.3,119.8
Stanford,2023,12,3,9,0.25,407,1423,3.5,15,118.6,233,2796,12.0,11,233.0,640,4219,6.6,26,233,425,54.8,2796,11,2.6,10,2.4,6.6,6.04,12.0,233.0,113.9
Stanford,2022,12,3,9,0.25,373,1288,3.5,14,107.3,275,3051,11.1,15,254.3,648,4339,6.7,29,275,448,62.4,3051,15,3.4,8,1.8,6.9,6.78,11.1,254.3,128.1
Syracuse,2024,13,10,3,0.769,389,1269,3.3,22,97.6,393,4810,12.2,34,370.0,782,6079,7.8,56,393,598,65.9,4810,34,5.7,12,2.0,8.1,8.31,12.2,370.0,148.5
Syracuse,2023,13,6,7,0.462,519,2240,4.3,20,172.3,192,2223,11.6,17,171.0,711,4463,6.3,37,192,316,60.8,2223,17,5.4,15,4.7,7.0,5.97,11.6,171.0,128.1
Syracuse,2022,13,7,6,0.538,434,1852,4.3,21,142.5,228,3015,13.2,19,231.9,662,4867,7.4,40,228,370,61.6,3015,19,5.1,9,2.4,8.1,8.08,13.2,231.9,142.2
Temple,2024,12,3,9,0.25,377,1113,3.0,10,92.8,242,2592,10.7,16,216.0,619,3705,6.0,26,242,411,58.9,2592,16,3.9,14,3.4,6.3,5.55,10.7,216.0,117.9
Temple,2023,12,3,9,0.25,324,1148,3.6,9,95.7,283,3320,11.7,23,276.7,607,4468,7.4,32,283,508,55.7,3320,23,4.5,16,3.1,6.5,6.02,11.7,276.7,119.2
Temple,2022,12,3,9,0.25,308,989,3.3,11,82.4,288,3217,11.2,18,268.1,596,4206,7.1,29,288,484,59.5,3217,18,3.7,12,2.5,6.6,6.27,11.2,268.1,122.7
Tennessee,2024,13,10,3,0.769,576,2936,5.1,34,225.8,236,2875,12.2,21,221.2,812,5811,7.2,55,236,374,63.3,2875,21,5.6,7,1.9,7.7,7.99,12.2,221.2,142.8
Tennessee,2023,13,9,4,0.692,486,2663,5.5,23,204.8,262,3162,12.1,22,243.2,748,5825,7.8,45,262,410,63.9,3162,22,5.4,5,1.2,7.7,8.24,12.1,243.2,144.0
Tennessee,2022,13,11,2,0.846,518,2593,5.0,40,199.5,290,4239,14.6,38,326.1,808,6832,8.5,78,290,422,68.9,4239,38,9.0,3,0.7,10.1,11.55,14.6,326.1,181.8
Texas,2024,16,13,3,0.813,570,2540,4.5,26,158.8,357,4460,12.5,40,278.8,927,7000,7.6,66,357,541,66.0,4460,40,7.4,14,2.6,8.2,8.56,12.5,278.8,154.5
Texas,2023,14,12,2,0.857,518,2638,5.1,29,188.4,317,4047,12.8,25,289.1,835,6685,8.0,54,317,475,66.9,4047,25,5.3,9,1.9,8.5,8.74,12.8,289.1,152.2
Texas,2022,13,8,5,0.615,464,2446,5.3,29,188.2,248,3138,12.7,22,241.4,712,5584,7.9,51,248,405,61.2,3138,22,5.4,7,1.7,7.7,8.06,12.7,241.4,140.8
Texas A&M,2024,13,8,5,0.615,518,2541,4.9,27,195.5,216,2734,12.7,19,210.3,734,5275,7.2,46,216,361,60.0,2734,19,5.3,11,3.1,7.6,7.28,12.7,210.3,135.1
Texas A&M,2023,13,7,6,0.538,453,1770,3.9,23,136.2,274,3520,12.8,24,270.8,727,5290,7.3,47,274,426,64.8,3520,24,5.7,10,2.4,8.3,8.39,12.8,270.8,148.7
Texas A&M,2022,12,5,7,0.417,360,1698,4.7,12,141.5,220,2633,12.0,18,219.4,580,4331,7.5,30,220,391,56.4,2633,18,4.6,6,1.5,6.8,6.98,12.0,219.4,125.3
Texas Christian,2024,13,9,4,0.692,387,1481,3.9,26,113.9,326,4068,12.5,29,312.9,713,5549,7.8,55,326,488,66.9,4068,29,6.0,11,2.3,8.4,8.53,12.5,312.9,152.2
Texas Christian,2023,12,5,7,0.417,404,1854,4.6,19,154.5,319,3746,11.7,27,312.2,723,5600,7.7,46,319,503,63.4,3746,27,5.4,15,3.0,7.4,7.18,11.7,312.2,137.7
Texas Christian,2022,15,13,2,0.867,550,2899,5.3,37,193.3,292,3926,13.4,33,261.7,842,6825,8.1,70,292,454,64.5,3926,33,7.3,8,1.8,8.7,9.33,13.4,261.7,157.8
Texas State,2024,13,8,5,0.615,521,2707,5.2,27,208.2,299,3493,11.7,31,268.7,820,6200,7.6,58,299,428,69.9,3493,31,7.2,14,3.3,8.2,8.14,11.7,268.7,155.8
Texas State,2023,13,8,5,0.615,515,2427,4.8,33,186.7,287,3522,12.3,24,270.9,802,5949,7.5,57,287,429,66.9,3522,24,5.6,9,2.1,8.2,8.38,12.3,270.9,150.1
Texas State,2022,12,4,8,0.333,380,1249,3.4,9,104.1,275,2653,9.6,19,221.1,655,3902,6.0,28,275,444,62.1,2653,19,4.3,10,2.3,6.0,5.83,9.6,221.1,122.0
Texas Tech,2024,13,8,5,0.615,467,2158,4.6,26,166.0,336,3857,11.5,31,296.7,803,6015,7.5,57,336,536,62.7,3857,31,5.8,11,2.1,7.2,7.43,11.5,296.7,138.1
Texas Tech,2023,13,7,6,0.538,465,2115,4.6,17,162.7,284,2912,10.3,24,224.0,749,5027,6.7,41,284,470,60.4,2912,24,5.1,18,3.8,6.2,5.49,10.3,224.0,121.7
Texas Tech,2022,13,8,5,0.615,516,2066,4.1,28,158.9,348,3926,11.3,26,302.5,864,5998,7.0,54,348,569,61.3,3932,26,4.6,18,3.2,6.9,6.4,11.3,302.5,128.1
Toledo,2024,13,8,5,0.615,429,1504,3.6,13,115.7,276,3305,12.0,28,254.2,705,4809,6.9,41,276,453,61.1,3305,28,6.2,8,1.8,7.3,7.75,12.0,254.2,139.4
Toledo,2023,14,11,3,0.786,507,2780,5.6,31,198.6,232,3089,13.3,26,220.6,739,5869,8.0,57,232,377,61.7,3089,26,6.9,10,2.7,8.2,8.4,13.3,220.6,148.2
Toledo,2022,14,9,5,0.643,569,2484,4.5,23,177.4,247,3153,12.8,31,225.2,816,5637,7.0,54,247,439,56.4,3153,31,7.1,15,3.4,7.2,7.07,12.8,225.2,133.4
Troy,2024,12,4,8,0.333,426,1874,4.6,17,156.2,213,2556,12.0,21,213.0,639,4430,7.0,38,213,339,62.8,2556,21,6.2,9,2.7,7.5,7.58,12.0,213.0,141.3
Troy,2023,14,11,3,0.786,481,2148,4.5,19,153.4,280,3724,13.3,29,266.0,761,5872,7.7,48,280,457,61.4,3724,29,6.4,6,1.3,8.2,8.85,13.3,266.0,148.4
Troy,2022,14,12,2,0.857,483,1638,3.5,21,117.0,251,3400,13.5,20,242.9,734,5038,6.9,41,251,401,62.6,3400,20,5.0,15,3.7,8.5,7.79,13.5,242.9,142.8
Tulane,2024,14,9,5,0.643,554,2739,5.0,32,195.6,207,2931,14.2,25,209.4,761,5670,7.5,57,207,329,62.9,2931,25,7.6,9,2.7,8.9,9.2,14.2,209.4,157.4
Tulane,2023,14,11,3,0.786,504,2171,4.4,16,155.1,229,3010,13.1,25,215.0,733,5181,7.1,41,229,368,62.2,3010,25,6.8,7,1.9,8.2,8.68,13.1,215.0,149.5
Tulane,2022,14,12,2,0.857,543,2867,5.3,34,204.8,241,3312,13.7,30,236.6,784,6179,7.9,64,241,379,63.9,3312,30,8.0,5,1.3,8.8,9.78,13.7,236.6,161.3
Tulsa,2024,12,3,9,0.25,450,1813,4.0,11,151.1,248,2863,11.5,23,238.6,698,4676,6.7,34,248,438,56.8,2863,23,5.3,12,2.7,6.6,6.37,11.5,238.6,123.7
Tulsa,2023,12,4,8,0.333,525,2169,4.2,13,180.8,190,2456,12.9,20,204.7,715,4625,6.5,33,190,334,56.9,2456,20,6.0,19,5.7,7.4,5.99,12.9,204.7,127.0
Tulsa,2022,12,5,7,0.417,419,1664,4.0,18,138.7,241,3278,13.6,27,273.2,660,4942,7.5,45,241,414,58.2,3278,27,6.5,10,2.4,7.9,8.14,13.6,273.2,141.4
UAB,2024,12,3,9,0.25,390,1571,4.0,9,130.9,284,3139,11.1,24,261.6,674,4710,7.0,33,284,446,63.8,3139,24,5.4,16,3.6,7.1,6.51,11.1,261.6,133.7
UAB,2023,12,4,8,0.333,422,1933,4.6,24,161.1,306,3467,11.3,22,288.9,728,5400,7.4,46,306,427,71.7,3467,22,5.2,13,3.0,8.1,7.78,11.3,288.9,150.8
UAB,2022,13,7,6,0.538,520,3055,5.9,32,235.0,194,2634,13.6,15,202.6,714,5689,8.0,47,194,321,61.0,2634,15,4.7,7,2.2,8.3,8.24,13.6,202.6,141.7
UCF,2024,12,4,8,0.333,516,2977,5.8,33,248.1,181,2396,13.2,14,199.7,697,5373,7.7,47,181,311,58.4,2396,14,4.5,11,3.5,7.7,7.04,13.2,199.7,131.1
UCF,2023,13,6,7,0.462,526,2967,5.7,28,228.2,229,3364,14.7,24,258.8,755,6331,8.4,52,229,366,62.7,3364,24,6.6,11,3.0,9.2,9.18,14.7,258.8,155.8
UCF,2022,14,9,5,0.643,607,3197,5.3,35,228.4,291,3377,11.6,22,241.2,898,6574,7.4,57,291,451,64.7,3377,22,4.9,9,2.0,7.5,7.58,11.6,241.2,139.8
UCLA,2024,12,5,7,0.417,330,1039,3.2,4,86.6,259,2906,11.2,17,242.2,589,3945,6.7,21,259,398,65.1,2906,17,4.3,11,2.8,7.3,6.91,11.2,242.2,135.0
UCLA,2023,13,8,5,0.615,514,2573,5.0,21,197.9,238,2979,12.5,24,229.2,752,5552,7.4,45,238,410,58.0,2979,24,5.9,14,3.4,7.3,6.9,12.5,229.2,131.6
UCLA,2022,13,9,4,0.692,501,3084,6.2,36,237.2,292,3463,11.9,29,266.4,793,6547,8.3,65,292,420,69.5,3463,29,6.9,12,2.9,8.2,8.34,11.9,266.4,155.9
USC,2024,13,7,6,0.538,357,1889,5.3,20,145.3,335,3795,11.3,29,291.9,692,5684,8.2,49,335,534,62.9,3795,29,5.4,15,2.8,7.1,6.94,11.3,291.9,135.0
USC,2023,13,8,5,0.615,347,1750,5.2,33,134.6,314,4329,13.8,37,333.0,661,6079,9.3,70,314,461,68.7,4329,37,8.1,6,1.3,9.5,10.5,13.8,333.0,172.4
USC,2022,14,11,3,0.786,462,2396,5.2,30,171.1,345,4696,13.6,43,335.4,807,7092,8.8,73,345,515,67.1,4696,43,8.4,5,1.0,9.1,10.37,13.6,335.4,169.5
UTEP,2024,12,3,9,0.25,436,1449,3.3,9,120.8,223,2400,10.8,15,200.0,659,3849,5.8,24,223,365,61.1,2400,15,4.1,12,3.3,6.6,5.92,10.8,200.0,123.3
UTEP,2023,12,3,9,0.25,445,1732,3.9,16,144.3,178,2612,14.7,13,217.7,623,4344,7.0,29,178,330,53.9,2612,13,3.9,12,3.6,7.9,7.07,14.7,217.7,126.2
UTEP,2022,12,5,7,0.417,458,2006,4.4,14,167.2,202,2612,12.9,15,217.7,660,4618,7.0,29,202,380,53.3,2612,15,4.0,12,3.2,6.9,6.26,12.9,217.7,117.9
UTSA,2024,13,7,6,0.538,478,2180,4.6,21,167.7,317,3685,11.6,27,283.5,795,5865,7.4,48,317,509,62.4,3685,27,5.3,13,2.6,7.3,7.17,11.6,283.5,135.8
UTSA,2023,13,9,4,0.692,500,2233,4.5,27,171.8,290,3248,11.2,25,249.8,790,5481,7.0,52,290,446,65.5,3248,25,5.6,14,3.2,7.3,7.04,11.2,249.8,139.4
UTSA,2022,14,11,3,0.786,526,2454,4.7,28,175.3,341,4210,12.3,34,300.7,867,6664,7.7,62,341,503,68.1,4210,34,6.8,9,1.8,8.4,8.95,12.3,300.7,157.5
Utah,2024,12,5,7,0.417,394,1565,4.0,7,130.4,199,2393,12.0,20,199.4,593,3958,6.7,27,199,358,55.6,2393,20,5.6,17,4.7,6.7,5.66,12.0,199.4,120.7
Utah,2023,13,8,5,0.615,552,2373,4.4,19,182.5,189,2156,11.4,15,165.8,741,4529,6.2,34,189,328,57.6,2156,15,4.6,11,3.4,6.6,5.98,11.4,165.8,121.2
Utah,2022,14,10,4,0.714,556,3047,5.5,38,217.6,288,3489,12.1,31,249.2,844,6536,7.7,69,288,446,64.9,3489,31,7.0,10,2.3,7.9,8.24,12.1,249.2,149.4
Utah State,2024,12,4,8,0.333,419,2383,5.7,21,198.6,294,3229,11.0,29,269.1,713,5612,7.9,50,294,458,64.2,3229,29,6.3,17,3.7,7.1,6.65,11.0,269.1,136.9
Utah State,2023,13,6,7,0.462,495,2397,4.8,18,184.4,269,3305,12.3,35,254.2,764,5702,7.5,53,269,436,61.7,3305,35,8.0,19,4.4,7.6,7.22,12.3,254.2,143.1
Utah State,2022,13,6,7,0.462,539,2069,3.9,14,159.2,230,2537,11.0,18,195.2,769,4606,6.0,32,230,398,57.9,2537,18,4.5,21,5.3,6.4,4.92,11.0,195.2,116.0
Vanderbilt,2024,13,7,6,0.538,458,1817,4.0,18,139.8,179,2322,13.0,21,178.6,637,4139,6.5,39,179,304,58.9,2322,21,6.9,4,1.3,7.6,8.43,13.0,178.6,143.2
Vanderbilt,2023,12,2,10,0.167,341,1143,3.4,10,95.3,217,2684,12.4,23,223.7,558,3827,6.9,33,217,390,55.6,2684,23,5.9,12,3.1,6.9,6.68,12.4,223.7,126.8
Vanderbilt,2022,12,5,7,0.417,438,1919,4.4,13,159.9,200,2248,11.2,22,187.3,638,4167,6.6,35,200,346,57.8,2248,22,6.4,6,1.7,6.5,6.99,11.2,187.3,129.9
Virginia,2024,12,5,7,0.417,425,1583,3.8,14,131.9,246,2748,11.2,16,229.0,671,4331,6.5,30,246,401,61.5,2748,16,4.0,14,3.5,6.9,6.1,11.2,229.0,125.4
Virginia,2023,12,3,9,0.25,447,1415,3.2,12,117.9,248,3010,12.1,19,250.8,695,4425,6.4,31,248,396,62.6,3010,19,4.8,14,3.5,7.6,6.97,12.1,250.8,135.2
Virginia,2022,10,3,7,0.3,326,1231,3.9,13,123.1,185,2210,11.9,7,221.0,511,3441,6.8,20,185,341,54.3,2210,7,2.1,12,3.5,6.5,5.31,11.9,221.0,108.4
Virginia Tech,2024,13,6,7,0.462,484,2319,4.8,28,178.4,200,2462,12.3,15,189.4,684,4781,7.0,43,200,339,59.0,2462,15,4.4,9,2.7,7.3,6.95,12.3,189.4,129.3
Virginia Tech,2023,13,7,6,0.538,492,2467,5.0,20,189.8,205,2622,12.8,23,201.7,697,5089,7.3,43,205,357,57.4,2622,23,6.4,5,1.4,7.3,8.0,12.8,201.7,137.6
Virginia Tech,2022,11,3,8,0.273,378,1212,3.4,15,110.2,203,2236,11.0,9,203.3,581,3448,6.1,24,203,346,58.7,2236,9,2.6,9,2.6,6.5,5.81,11.0,203.3,116.3
Wake Forest,2024,12,4,8,0.333,432,1567,3.7,18,130.6,248,2881,11.6,17,240.1,680,4448,6.6,35,248,404,61.5,2881,17,4.2,13,3.2,7.1,6.54,11.6,240.1,129.1
Wake Forest,2023,12,4,8,0.333,461,1565,3.4,13,130.4,194,2368,12.2,14,197.3,655,3933,6.0,27,194,321,60.4,2368,14,4.4,11,3.4,7.4,6.71,12.2,197.3,129.9
Wake Forest,2022,13,8,5,0.615,492,1696,3.5,17,130.5,302,4055,13.4,43,311.9,794,5751,7.3,60,302,473,63.8,4055,43,9.1,13,2.7,8.6,9.15,13.4,311.9,160.4
Washington,2024,13,6,7,0.462,417,1674,4.1,14,128.8,302,3402,11.3,22,261.7,719,5076,7.1,36,302,417,72.6,3402,22,5.3,8,1.9,8.2,8.37,11.3,261.7,154.9
Washington,2023,15,14,1,0.933,391,1776,4.6,28,118.4,376,5155,13.7,38,343.7,767,6931,9.1,66,376,574,65.5,5155,38,6.6,12,2.1,9.0,9.36,13.7,343.7,158.6
Washington,2022,13,11,2,0.846,388,1898,5.0,33,146.0,373,4807,12.9,32,369.8,761,6705,8.9,65,373,575,65.2,4807,32,5.6,9,1.6,8.4,8.81,12.9,369.8,151.1
Washington State,2024,13,8,5,0.615,461,2168,4.7,28,166.8,263,3589,13.6,33,276.1,724,5757,8.0,61,263,399,65.9,3589,33,8.3,9,2.3,9.0,9.63,13.6,276.1,164.3
Washington State,2023,12,5,7,0.417,334,1018,3.1,17,84.8,340,4042,11.9,27,336.8,674,5060,7.5,44,340,510,66.7,4042,27,5.3,9,1.8,7.9,8.19,11.9,336.8,147.2
Washington State,2022,13,7,6,0.538,352,1389,4.1,17,106.8,323,3300,10.2,24,253.8,675,4689,7.0,41,323,500,64.6,3300,24,4.8,9,1.8,6.6,6.75,10.2,253.8,132.3
West Virginia,2024,13,6,7,0.462,517,2518,4.9,27,193.7,226,2734,12.1,20,210.3,743,5252,7.1,47,226,371,60.9,2734,20,5.4,14,3.8,7.4,6.75,12.1,210.3,133.1
West Virginia,2023,13,9,4,0.692,552,2976,5.4,32,228.9,178,2674,15.0,18,205.7,730,5650,7.8,50,178,331,53.8,2674,18,5.4,7,2.1,8.1,8.21,15.0,205.7,135.4
West Virginia,2022,12,5,7,0.417,441,2058,4.7,24,171.5,254,2730,10.7,20,227.5,695,4788,6.9,44,254,425,59.8,2730,20,4.7,12,2.8,6.4,6.09,10.7,227.5,123.6
Western Kentucky,2024,14,8,6,0.571,430,1524,3.6,14,108.9,309,3705,12.0,28,264.6,739,5229,7.1,42,309,470,65.9,3705,28,6.0,12,2.6,7.9,7.94,12.0,264.6,146.8
Western Kentucky,2023,13,8,5,0.615,347,1370,4.0,12,105.4,343,3853,11.2,38,296.4,690,5223,7.6,50,343,539,63.6,3853,38,7.1,14,2.6,7.1,7.39,11.2,296.4,141.8
Western Kentucky,2022,14,9,5,0.643,406,2031,5.0,15,145.1,401,4931,12.3,43,352.2,807,6962,8.6,58,401,623,64.6,4931,43,6.9,12,1.9,7.9,8.46,12.3,352.2,150.3
Western Michigan,2024,13,6,7,0.462,473,2379,5.1,28,183.0,212,2431,11.5,18,187.0,685,4810,7.1,46,212,323,65.6,2431,18,5.6,9,2.8,7.5,7.39,11.5,187.0,141.7
Western Michigan,2023,12,4,8,0.333,472,1846,3.9,21,153.8,247,2534,10.3,13,211.2,719,4380,6.1,34,247,393,62.8,2534,13,3.3,9,2.3,6.4,6.08,10.3,211.2,123.3
Western Michigan,2022,12,5,7,0.417,458,1635,3.6,14,136.3,167,1988,11.9,10,165.7,625,3623,5.8,24,167,335,49.9,1988,10,3.0,13,3.9,5.9,4.79,11.9,165.7,101.8
Wisconsin,2024,12,5,7,0.417,419,1844,4.4,19,153.7,208,2360,11.3,14,196.7,627,4204,6.7,33,208,365,57.0,2360,14,3.8,10,2.7,6.5,6.0,11.3,196.7,118.5
Wisconsin,2023,13,7,6,0.538,450,2093,4.7,22,161.0,281,2862,10.2,14,220.2,731,4955,6.8,36,281,469,60.2,2862,14,3.0,5,1.1,6.1,6.25,10.2,220.2,119.4
Wisconsin,2022,13,7,6,0.538,497,2337,4.7,21,179.8,188,2390,12.7,21,183.8,685,4727,6.9,42,188,326,57.7,2390,21,6.4,11,3.4,7.3,7.1,12.7,183.8,133.8
Wyoming,2024,12,3,9,0.25,448,1654,3.8,14,137.8,181,2273,12.6,11,189.4,629,3927,6.3,25,181,347,52.3,2273,11,3.2,11,3.2,6.6,5.77,12.6,189.4,111.6
Wyoming,2023,13,9,4,0.692,461,2060,4.5,19,158.5,189,2191,11.6,20,168.5,650,4251,6.6,39,189,304,62.2,2191,20,6.6,6,2.0,7.2,7.63,11.6,168.5,140.5
Wyoming,2022,13,7,6,0.538,470,2358,5.1,16,181.4,156,1719,11.0,11,132.2,626,4077,6.5,27,156,304,51.3,1719,11,3.6,12,3.9,5.7,4.6,11.0,132.2,102.9
